TILEMAP
100 8							-- Size of tile map in tiles
32 32							-- Tile size & block size
21 21 0 0 0 0 0 0 0 0 0 0 0 0 0 0 0 0 0 0 0 0 0 0 0 0 0 0 0 0 0 0 0 0 0 0 0 0 14 0 0 0 0 0 0 0 10 0 0 0 3 0 0 0 0 0 0 0 0 14 0 0 0 0 0 0 0 12 4 2 0 0 0 0 0 0 0 14 0 0 0 0 0 0 4 4 0 0 0 0 0 0 0 0 0 0 0 0 0 0 
21 21 0 0 0 0 0 0 0 0 0 0 0 0 0 0 0 0 0 0 0 0 0 0 0 0 0 0 0 0 0 0 0 0 0 0 0 0 0 0 0 0 0 0 0 0 0 6 0 0 3 0 0 0 0 14 0 0 0 0 0 0 0 0 0 0 0 6 4 0 0 0 0 0 0 0 0 0 0 14 0 0 0 10 4 4 4 0 0 0 0 0 0 0 0 0 0 0 0 0 
21 21 0 0 0 0 0 0 0 0 0 0 0 0 0 0 0 0 0 0 0 0 0 0 0 0 0 0 0 0 0 0 0 0 14 0 0 0 0 0 14 0 0 0 0 0 0 0 13 0 3 0 0 14 0 0 0 0 0 0 0 0 0 0 0 0 0 0 4 0 2 0 2 0 0 0 0 0 14 0 0 0 0 6 4 4 4 4 0 0 0 0 0 0 0 0 0 0 0 0 
21 21 0 0 0 0 0 0 0 0 0 0 0 0 0 0 0 0 0 0 0 0 0 0 0 0 0 0 0 0 0 0 0 0 0 0 0 14 0 0 0 0 0 0 0 0 0 0 0 0 3 0 0 0 0 0 0 14 0 0 14 0 0 0 0 0 0 7 4 2 0 0 0 0 0 0 0 0 0 0 14 0 0 0 4 4 4 4 4 3 0 0 0 0 0 0 0 0 0 0 
21 21 0 0 0 0 0 0 0 0 0 0 0 0 0 0 0 0 0 0 0 0 0 0 0 0 0 1 0 0 0 0 14 0 0 0 0 0 0 0 0 0 0 0 0 0 0 0 0 0 3 0 0 0 0 14 0 0 0 0 0 0 0 0 0 0 0 0 4 0 0 2 0 0 2 0 0 14 0 5 0 0 0 0 4 4 4 4 4 0 0 0 0 0 0 0 0 0 0 0 
21 21 0 0 0 0 0 0 0 0 0 0 0 0 0 0 0 0 0 0 0 0 0 0 0 0 0 0 0 0 0 0 0 0 0 0 0 14 0 0 14 0 0 0 0 0 0 0 0 0 3 0 0 0 0 0 0 14 0 14 0 0 0 0 0 0 0 0 4 2 0 2 0 2 0 0 0 0 0 14 0 0 0 0 4 4 4 4 0 8 6 9 17 11 0 0 0 12 6 13 
21 21 0 0 0 0 0 0 0 0 0 0 0 0 0 0 0 0 0 0 0 0 0 0 0 0 0 0 0 0 0 0 0 0 14 0 0 0 0 0 0 0 14 0 0 0 0 0 0 0 3 0 0 0 0 0 0 14 0 0 0 0 0 0 0 0 13 0 4 0 2 0 0 0 0 0 0 0 14 0 0 0 0 0 4 4 4 0 0 0 0 0 0 0 0 0 0 15 6 16 
21 21 0 0 0 0 0 0 0 0 0 0 0 0 0 0 0 0 0 0 0 0 0 0 0 0 0 0 0 0 0 0 0 0 0 0 0 0 0 0 0 0 0 0 0 0 0 0 0 0 3 10 6 11 0 0 0 0 0 0 0 14 0 0 8 6 0 0 4 0 0 2 0 0 0 0 14 0 0 14 0 0 0 0 4 4 0 0 0 0 0 0 0 0 0 0 0 5 6 7
