TILEMAP
25 25							-- Size of tile map in tiles
32 32							-- Tile size & block size
0 0 0 0 0 0 0 0 0 0 0 0 0 0 0 0 0 0 0 0 0 0 15 6 16 
0 0 0 0 0 0 0 0 0 0 0 0 0 0 0 0 0 0 0 0 0 0 0 0 0 
0 0 0 0 0 0 0 0 0 0 4 4 4 4 4 4 4 4 0 0 0 0 0 0 0 
0 0 0 0 0 0 0 0 0 0 4 0 0 0 0 0 0 4 0 0 0 0 0 0 0 
0 0 0 0 0 0 0 0 0 0 4 0 6 0 0 0 0 4 0 0 0 0 0 0 0 
0 0 0 0 0 0 0 0 0 0 4 0 0 0 0 0 0 4 0 0 0 0 0 0 0 
0 0 0 0 0 0 0 0 0 0 4 0 0 0 0 9 0 4 0 0 0 0 0 0 0 
0 0 0 0 0 0 4 4 4 4 4 0 0 0 0 0 0 4 0 0 0 0 0 0 0 
0 0 0 0 0 0 4 14 14 14 14 0 0 0 0 0 0 4 0 0 0 0 0 0 0 
0 0 0 0 0 0 4 14 5 14 14 0 0 0 0 0 0 4 0 0 0 0 0 0 0 
0 0 0 0 0 0 4 14 14 14 14 0 0 0 0 0 0 4 0 0 0 0 0 0 0 
0 0 0 0 0 0 4 4 4 4 4 4 4 4 4 4 4 4 0 0 0 0 0 0 0 
0 0 0 0 0 0 0 0 0 0 4 0 0 0 0 0 0 4 0 0 0 0 0 0 0 
0 0 0 0 0 0 0 10 0 0 4 0 8 0 0 3 0 4 0 0 0 0 0 0 0 
0 0 0 0 0 0 0 6 0 0 4 0 6 0 0 0 0 4 0 0 0 0 0 0 0 
0 0 0 0 0 0 0 7 0 0 4 0 11 0 0 0 0 4 0 0 0 0 0 0 0 
0 0 0 0 0 0 0 0 0 0 4 0 0 0 4 4 4 4 0 0 0 0 0 0 0 
0 0 0 0 0 0 0 0 0 0 4 4 4 4 4 0 0 0 0 0 0 0 0 0 0 
0 0 0 0 0 0 0 0 0 0 0 0 0 0 0 0 0 0 0 0 0 0 0 0 0 
0 0 0 0 0 0 0 0 0 0 0 0 0 0 0 0 0 0 0 0 0 0 0 0 0

