TILEMAP
16 16 							-- Size of tile map in tiles
32 32 							-- Tile size & block size
0 0 0 9 8 14 0 0 0 0 7 8 15 0 0 0 
0 0 0 0 0 0 0 0 0 0 0 0 0 0 0 0 
0 0 0 3 3 3 3 3 3 3 3 3 3 0 0 0 
0 0 0 0 0 0 0 0 2 0 0 0 0 0 0 0 
0 0 0 0 1 0 0 0 2 0 0 4 0 0 0 0 
0 0 0 0 0 0 0 0 2 0 0 0 0 0 0 0 
0 0 0 3 3 3 3 3 3 3 3 3 3 0 0 0 
0 0 0 0 0 0 0 0 0 0 0 0 0 0 0 0 
0 0 0 11 8 16 0 0 0 0 10 8 13 0 0 0 
0 0 0 0 0 0 0 0 0 0 0 0 0 0 0 0 
0 0 0 0 0 0 0 0 0 0 0 0 0 0 0 0 
0 0 0 0 0 0 0 0 0 0 0 0 0 0 0 0

